4 6
101111
101010
101011
111011

=> 14

4 6
110110
110110
111111
111101

==> 8

2 25
1011101110111011101110111
1110111011101110111011101

==> 37